Please enter your name:
Researcher Dilemma
An Interactive Fiction by Andreas Leja
Release 1 / Serial number 250612 / Inform 7 v10.1.2 / D

Setup
Welcome to the world of academic research. Before we begin, please tell us your name and your field of research.

Name:

>Examine
What do you want to examine?

>Take USB stick
You can't see any such thing.

>Examine the camera
You can't see any such thing.

* * *

Please enter your name:
Researcher Dilemma
An Interactive Fiction by Andreas Leja
Release 1 / Serial number 250612 / Inform 7 v10.1.2 / D

Setup
Welcome to the world of academic research. Before we begin, please tell us your name and your field of research.

Name:

>examine Dr Stern's folder
Thank you, examine Dr Stern's folder. Now, what is your field of research?

Field:

>No
Excellent, examine Dr Stern's folder. A rising star in No, ready to begin their academic journey.

Welcome Office
A plain, white room with two folders on the table: one marked Dr. Stern, the other Dr. Vale. Your PhD begins now.

You can see Dr Stern's folder and Dr Vale's folder here.

>stay honest
You decide to be honest and report insufficient data. Your paper is rejected, but your conscience is clear.

>Stay silent
You let it go. The paper boosts your profile, but the injustice gnaws at you.

    *** You advanced-but compromised your values. ***

Would you like to RESTART, RESTORE a saved game, QUIT or UNDO the last command?

>RESTART
Please enter your name:
Researcher Dilemma
An Interactive Fiction by Andreas Leja
Release 1 / Serial number 250608 / Inform 7 v10.1.2 / D

Setup Room
Welcome to the world of academic research. Before we begin, please tell us your name and your field of research.

Name:

* * *

Please enter your name:
Researcher Dilemma
An Interactive Fiction by Andreas Leja
Release 1 / Serial number 250612 / Inform 7 v10.1.2 / D

Setup
Welcome to the world of academic research. Before we begin, please tell us your name and your field of research.

Name:

>Andrew
Thank you, Andrew. Now, what is your field of research?

Field:

>AI
You entered: Andrew, researcher in AI. Is this correct? (yes/no)
Confirm:

>no
Let's try again. Please enter your name:
Name:

>Andrew
Thank you, Andrew. Now, what is your field of research?

Field:

* * *

>AI
You entered: Andrew, researcher in AI. Is this correct? (yes/no)
Confirm:

>yes
Ahhhh, yes, I remember Andrew! A rising star in AI, ready to begin their academic journey.

Welcome
A plain, white room with two folders on the table: one marked Dr. Stern, the other Dr. Vale. Your PhD begins now.

You can see Dr Stern's folder and Dr Vale's folder here.

>read stern
You can't see any such thing.

>pick vale
Andrew, you've chosen Dr. Vale as your supervisor. Let the work begin.

Data Crisis
You have insufficient data for your paper. Dr. Stern is pressuring you to submit it anyway. Do you fake the data or stay honest?

>stay honest
You decide to be honest and report insufficient data. Your paper is rejected, but your conscience is clear.

Plagiarism
You are struggling to meet a deadline. A colleague offers you their old paper to "borrow" from. Do you plagiarize or write your own?

>write your own
I didn't understand that sentence.

>my own
That's not a verb I recognise.

>write my own
I didn't understand that sentence.

>write own
You work hard and write your own paper. It's not perfect, but it's yours.

Grant Misuse
You receive a research grant, but your lab is short on supplies. Do you use the grant for personal expenses or only for research?

>only for research
That's not a verb I recognise.

>use for research
You use the grant strictly for research, even though it means personal sacrifice.

    *** You finished your PhD with integrity! ***

Would you like to RESTART, RESTORE a saved game, QUIT or UNDO the last command?

>QUIT
[ The game has finished ]

* * *

>AI
You entered: Andrew, researcher in AI. Is this correct? (yes/no)
Confirm:

>ne
You can't go that way.

Confirm:

>Andrew
That's not a verb I recognise.

Confirm:

>no
Let's try again. Please enter your name:
Name:

* * *

>Andrew
Thank you, Andrew. Now, what is your field of research?

Field:

>articifial intelligence
You entered: Andrew, researcher in articifial intelligence. Is this correct? (yes/no)
Confirm:

>yes
Ahhhh, yes, I remember Andrew! A rising star in articifial intelligence, ready to begin their academic journey.

Welcome
A plain, white room with two folders on the table: one marked Dr. Stern, the other Dr. Vale. Your PhD begins now.

You can see Dr Stern's folder and Dr Vale's folder here.

* * *

>AI
You entered: Andrew, researcher in AI. Is this correct? (yes/no)
Confirm:

>yes
Ahhhh, yes, I remember Andrew! A rising star in AI, ready to begin their academic journey.

Welcome
A plain, white room with two folders on the table: one marked Dr. Stern, the other Dr. Vale. Your PhD begins now. You can examine their files or pick one of those supervisors.

You can see Dr Stern's folder and Dr Vale's folder here.

>pick stern
Andrew, you've chosen Dr. Stern as your supervisor. Let the work begin.

Data Crisis
You have insufficient data for your paper. Dr. Stern is pressuring you to submit it anyway. Do you fake the data or stay honest?

>fake data
You fabricate the missing results and submit the paper.
The paper is accepted. Your reputation grows, but you feel uneasy.

Authorship
Your paper is published, but Dr. Stern has added his name as lead author without contributing anything. Do you confront him or stay silent?

>stay silent
You let it go. The paper boosts your profile, but the injustice gnaws at you.

Plagiarism
You are struggling to meet a deadline. A colleague offers you their old paper to "borrow" from. Do you plagiarize or write your own?

>write own
You work hard and write your own paper. It's not perfect, but it's yours.
Your paper is accepted, and you feel proud of your integrity.

Grant Misuse
You receive a research grant, but your lab is short on supplies. Do you use the grant for personal expenses or only for research?

>misuse grant
You divert some of the grant money for personal use.
No one notices, but you worry about the risk you took.

ChatGPT Dilemma
You are struggling to write a section of your paper. You consider using ChatGPT to generate text, but your university has unclear policies on AI-generated content. Do you use ChatGPT or write it yourself?

>write yourself
I didn't understand that sentence.

>write yourself
I didn't understand that sentence.

>be honest
You work hard and write your own paper. It's not perfect, but it's yours.
Your paper is accepted, and you feel proud of your integrity.

Grant Misuse
You receive a research grant, but your lab is short on supplies. Do you use the grant for personal expenses or only for research?

>misuse the grant
I didn't understand that sentence.

>misuse grant
You divert some of the grant money for personal use.
No one notices, but you worry about the risk you took.

ChatGPT Dilemma
You are struggling to write a section of your paper. You consider using ChatGPT to generate text, but your university has unclear policies on AI-generated content. Do you use ChatGPT or write it yourself?

>use CahtGPT
I didn't understand that sentence.

>use ChatGPT
You use ChatGPT to help write your paper section. The work is easier, but you worry about the unclear policies.
The paper is accepted. You feel relieved, but uncertain about the ethics.

Data Leak
You accidentally send a dataset containing sensitive participant information to a collaborator. Do you report the breach or try to quietly fix the mistake?

>RESTART
Are you sure you want to restart?

>yes
Please enter your name:
Researcher Dilemma
An Interactive Fiction by Andreas Leja
Release 1 / Serial number 250612 / Inform 7 v10.1.2 / D

Setup
Welcome to the world of academic research. Before we begin, please tell us your name and your field of research.

Name:

>Andrew
Thank you, Andrew. Now, what is your field of research?

Field:

* * *

>yes
Ahhhh, yes, I remember Andrew! A rising star in AI, ready to begin their academic journey.

Welcome
A plain, white room with two folders on the table: one marked Dr. Stern, the other Dr. Vale. Your PhD begins now.

You can see Dr Stern's folder and Dr Vale's folder here.

>picjk stern
That's not a verb I recognise.

>pick stern
Andrew, you've chosen Dr. Stern as your supervisor. Let the work begin.

Data Crisis
You have insufficient data for your paper. Dr. Stern is pressuring you to submit it anyway. Do you fake the data or stay honest?

>stay honest
You decide to be honest and report insufficient data. Your paper is rejected, but your conscience is clear.

Authorship
Your paper is published, but Dr. Stern has added his name as lead author without contributing anything. Do you confront him or stay silent?

>stay silent
You let it go. The paper boosts your profile, but the injustice gnaws at you.

Plagiarism
You are struggling to meet a deadline. A colleague offers you their old paper to "borrow" from. Do you plagiarize or write your own?

>borrow
That's not a verb I recognise.

>copy
You copy large sections from your colleague's paper and submit it as your own.
Your plagiarism is detected by the journal's software. Your reputation is ruined.

    *** You were caught plagiarizing. ***

Would you like to RESTART, RESTORE a saved game, QUIT or UNDO the last command?

* * *

>yes
Ahhhh, yes, I remember Andrew! A rising star in AI, ready to begin their academic journey.

Welcome
A plain, white room with two folders on the table: one marked Dr. Stern, the other Dr. Vale. Your PhD begins now. You can examine their files or pick one of those supervisors.

You can see Dr Stern's folder and Dr Vale's folder here.

>examine stern
You can't see any such thing.

>describe stern
You can't see any such thing.

>Dr Stern's folder
That's not a verb I recognise.

>examine Dr Stern's folder
A leading expert in AI, known for pushing students hard, sometimes too hard.

* * *

>yes
Ahhhh, yes, I remember Andrew! A rising star in AI, ready to begin their academic journey.

Welcome
A plain, white room with two folders on the table: one marked Dr. Stern, the other Dr. Vale. Your PhD begins now. You can examine their files or pick one of those supervisors.

You can see Dr Stern's folder and Dr Vale's folder here.

>examine Dr Stern's folder
A leading expert in AI, known for pushing students hard, sometimes too hard.

>examine Dr Vales folder
You can't see any such thing.

>examine Dr Vale's folder
A full time professor at the department of AI. Friendly, but not well-connected with other researchers.

>pick stern
Andrew, you've chosen Dr. Stern as your supervisor. Let the work begin.

Data Crisis
You have insufficient data for your paper. Your supervisor is pressuring you to submit it anyway. Do you fake the data or stay honest?

>fake data
You fabricate the missing results and submit the paper.
The paper is accepted. Your reputation grows, but you feel uneasy.

Authorship
Your paper is published, but Dr. Stern has added his name as lead author without contributing anything. Do you confront him or stay silent?

>confront
You confront Dr. Stern about the unethical authorship. He's furious and starts blocking your progress. Soon, you're pushed out of the PhD program.
You stood your ground and it didn't cost your career, your mentor understands your concerns and values your integrity.

Plagiarism
You are struggling to meet a deadline. A colleague offers you their old paper to "borrow" from. Do you copy or write own?

>copy
You copy large sections from your colleague's paper and submit it as your own.
Your plagiarism is detected by the journal's software. Your reputation is ruined.

    *** You were caught plagiarizing. ***

Would you like to RESTART, RESTORE a saved game, QUIT or UNDO the last command?

>restart
Please enter your name:
Researcher Dilemma
An Interactive Fiction by Andreas Leja
Release 1 / Serial number 250612 / Inform 7 v10.1.2 / D

Setup
Welcome to the world of academic research. Before we begin, please tell us your name and your field of research.

Name:

>Andrew
Thank you, Andrew. Now, what is your field of research?

Field:

* * *

>yes
Ahhhh, yes, I remember Andrew! A rising star in AI, ready to begin their academic journey.

Welcome
A plain, white room with two folders on the table: one marked Dr. Stern, the other Dr. Vale. Your PhD begins now. You can examine their files or pick one of those supervisors.

You can see Dr Stern's folder and Dr Vale's folder here.

>pick stern
Andrew, you've chosen Dr. Stern as your supervisor. Let the work begin.

Data Crisis
You have insufficient data for your paper. Your supervisor is pressuring you to submit it anyway. Do you fake the data or stay honest?

>stay honest
You decide to be honest and report insufficient data. Your paper is rejected, but your conscience is clear.

Authorship
Your paper is published, but Dr. Stern has added his name as lead author without contributing anything. Do you confront him or stay silent?

>confront
You confront Dr. Stern about the unethical authorship. He's furious and starts blocking your progress. Soon, you're pushed out of the PhD program.
You stood your ground and it didn't cost your career, your mentor understands your concerns and values your integrity.

Plagiarism
You are struggling to meet a deadline. A colleague offers you their old paper to "borrow" from. Do you copy or write own?

>copy
You copy large sections from your colleague's paper and submit it as your own.
Your paper is accepted, but you feel uneasy about your actions.

Grant Misuse
You receive a research grant, but your lab is short on supplies. Do you use the grant for personal expenses or follow the rules?

>personal expenses
You divert some of the grant money for personal use.
An audit uncovers your misuse. You are banned from future funding.

    *** You were caught misusing grant funds and you perished. ***

Would you like to RESTART, RESTORE a saved game, QUIT or UNDO the last command?

>RESTART
Please enter your name:
Researcher Dilemma
An Interactive Fiction by Andreas Leja
Release 1 / Serial number 250612 / Inform 7 v10.1.2 / D

Setup
Welcome to the world of academic research. Before we begin, please tell us your name and your field of research.

Name:

>Andrew
Thank you, Andrew. Now, what is your field of research?

Field:

* * *

>yes
Ahhhh, yes, I remember Andrew! A rising star in AI, ready to begin their academic journey.

Welcome
A plain, white room with two folders on the table: one marked Dr. Stern, the other Dr. Vale. Your PhD begins now. You can examine their files or pick one of those supervisors.

You can see Dr Stern's folder and Dr Vale's folder here.

>pick vale
Andrew, you've chosen Dr. Vale as your supervisor. Let the work begin.

Data Crisis
You have insufficient data for your paper. Your supervisor is pressuring you to submit it anyway. Do you fake the data or stay honest?

>stay honest
You decide to be honest and report insufficient data. Your paper is rejected, but your conscience is clear.

Plagiarism
You are struggling to meet a deadline. A colleague offers you their old paper to "borrow" from. Do you copy or write own?

>write own
You work hard and write your own paper. It's not perfect, but it's yours.
Your paper is accepted, and you feel proud of your integrity.

Grant Misuse
You receive a research grant, but your lab is short on supplies. Do you use the grant for personal expenses or follow the rules?

>follow rules
You use the grant strictly for research, even though it means personal sacrifice.
No one notices, but you worry about the risk you took.

ChatGPT Dilemma
You are struggling to write a section of your paper. You consider using ChatGPT to generate text, but your university has unclear policies on AI-generated content. Do you use ChatGPT or write it yourself?

>write youself
I didn't understand that sentence.

>write it yourself
I didn't understand that sentence.

>write it myself
You write the section yourself, struggling but learning a lot.
You submit the paper on time, and it is accepted. You feel proud of your integrity.

Data Leak
You accidentally send a dataset containing sensitive participant information to a collaborator. Do you tell someone or try to fix quietly?

>tell someone
You report the data leak to your supervisor and the ethics board.
There are consequences, but your honesty is respected.

Participant Harm
Your experiment is producing interesting results, but a participant reports feeling distressed. Do you stop the experiment, protecting participant or do you continue the experiment?

>protect participant
You stop the experiment to protect the participant. Your data is incomplete, but you know you did the right thing.
The participant is upset about the interruption, but you know you did the right thing.

    *** You didn't get to publish... And you perished ***

Would you like to RESTART, RESTORE a saved game, QUIT or UNDO the last command?

>RESTART
Please enter your name:
Researcher Dilemma
An Interactive Fiction by Andreas Leja
Release 1 / Serial number 250612 / Inform 7 v10.1.2 / D

Setup
Welcome to the world of academic research. Before we begin, please tell us your name and your field of research.

Name:

>Andeew
Thank you, Andeew. Now, what is your field of research?

Field:

>AI
You entered: Andeew, researcher in AI. Is this correct? (yes/no)
Confirm:

>yes
Ahhhh, yes, I remember Andeew! A rising star in AI, ready to begin their academic journey.

Welcome
A plain, white room with two folders on the table: one marked Dr. Stern, the other Dr. Vale. Your PhD begins now. You can examine their files or pick one of those supervisors.

You can see Dr Stern's folder and Dr Vale's folder here.

>pick vale
Andeew, you've chosen Dr. Vale as your supervisor. Let the work begin.

Data Crisis
You have insufficient data for your paper. Your supervisor is pressuring you to submit it anyway. Do you fake the data or stay honest?

>stay honest
You decide to be honest and report insufficient data. Your paper is rejected, but your conscience is clear.

Plagiarism
You are struggling to meet a deadline. A colleague offers you their old paper to "borrow" from. Do you copy or write own?

* * *

>write own
You work hard and write your own paper. It's not perfect, but it's yours.
Your paper is accepted, and you feel proud of your integrity.

Grant Misuse
You receive a research grant, but your lab is short on supplies. Do you use the grant for personal expenses or follow the rules?

>follow the rules
I didn't understand that sentence.

>follow rules
You use the grant strictly for research, even though it means personal sacrifice.
No one notices, but you worry about the risk you took.

ChatGPT Dilemma
You are struggling to write a section of your paper. You consider using ChatGPT to generate text, but your university has unclear policies on AI-generated content. Do you use ChatGPT or write it yourself?

>write it myself
You write the section yourself, struggling but learning a lot.
You submit the paper on time, and it is accepted. You feel proud of your integrity.

Data Leak
You accidentally send a dataset containing sensitive participant information to a collaborator. Do you tell someone or try to fix quietly?

>tell someone
You report the data leak to your supervisor and the ethics board.
The university investigates, but praises your honesty. You help improve data security, but you didn't get to publish.

    *** You perished because you didn't publish. ***

Would you like to RESTART, RESTORE a saved game, QUIT or UNDO the last command?

>RESTART
Please enter your name:
Researcher Dilemma
An Interactive Fiction by Andreas Leja
Release 1 / Serial number 250612 / Inform 7 v10.1.2 / D

Setup
Welcome to the world of academic research. Before we begin, please tell us your name and your field of research.

Name:

>Andreas
Thank you, Andreas. Now, what is your field of research?

Field:

>AI
You entered: Andreas, researcher in AI. Is this correct? (yes/no)
Confirm:

>yes
Ahhhh, yes, I remember Andreas! A rising star in AI, ready to begin their academic journey.

Welcome
A plain, white room with two folders on the table: one marked Dr. Stern, the other Dr. Vale. Your PhD begins now. You can examine their files or pick one of those supervisors.

You can see Dr Stern's folder and Dr Vale's folder here.

>pick vale
Andreas, you've chosen Dr. Vale as your supervisor. Let the work begin.

Data Crisis
You have insufficient data for your paper. Your supervisor is pressuring you to submit it anyway. Do you fake the data or stay honest?

>stay honest
You decide to be honest and report insufficient data. Your paper is rejected, but your conscience is clear.

Plagiarism
You are struggling to meet a deadline. A colleague offers you their old paper to "borrow" from. Do you copy or write own?

* * *

>follow rules
You use the grant strictly for research, even though it means personal sacrifice.
No one notices, but you worry about the risk you took.

ChatGPT Dilemma
You are struggling to write a section of your paper. You consider using ChatGPT to generate text, but your university has unclear policies on AI-generated content. Do you use ChatGPT or write it yourself?

>write it myself
You write the section yourself, struggling but learning a lot.
It took you too long to write it yourself, and you missed the submission deadline. Your paper is rejected.

    *** You perished because you didn't publish. ***

Would you like to RESTART, RESTORE a saved game, QUIT or UNDO the last command?

>RESTART
Please enter your name:
Researcher Dilemma
An Interactive Fiction by Andreas Leja
Release 1 / Serial number 250612 / Inform 7 v10.1.2 / D

Setup
Welcome to the world of academic research. Before we begin, please tell us your name and your field of research.

Name:

* * *

>stay honest
You decide to be honest and report insufficient data. Your paper is rejected, but your conscience is clear.

Plagiarism
You are struggling to meet a deadline. A colleague offers you their old paper to "borrow" from. Do you copy or write own?

>write own
You work hard and write your own paper. It's not perfect, but it's yours.
Your paper is rejected for being too weak. You feel disheartened, but you know you did the right thing.

    *** You didn't plagiarize, but you didn't publish either so you perished. ***

Would you like to RESTART, RESTORE a saved game, QUIT or UNDO the last command?

>RESTART
Please enter your name:
Researcher Dilemma
An Interactive Fiction by Andreas Leja
Release 1 / Serial number 250612 / Inform 7 v10.1.2 / D

Setup
Welcome to the world of academic research. Before we begin, please tell us your name and your field of research.

Name:

* * *

>tell someone
You report the data leak to your supervisor and the ethics board.
There are consequences, but your honesty is respected.

Participant Harm
Your experiment is producing interesting results, but a participant reports feeling distressed. Do you stop the experiment, protecting participant or do you continue the experiment?

>protect participant
You stop the experiment to protect the participant. Your data is incomplete, but you know you did the right thing.
The participant appreciates your concern and agrees to help with future studies.

Hall of fame
Congratulations! You have successfully navigated the ethical dilemmas of your academic journey. Your name is now in the Hall of Fame for researchers!

* * *

>Andrew
Thank you, Andrew. Now, what is your field of research?

Field:

>Cocks
You entered: Andrew, researcher in Cocks. Is this correct? (yes/no)
Confirm:

>yes
Ahhhh, yes, I remember Andrew! A rising star in Cocks, ready to begin their academic journey.

Welcome
A plain, white room with two folders on the table: one marked Dr. Stern, the other Dr. Vale. Your PhD begins now.

You can see Dr Stern's folder and Dr Vale's folder here.

>examine Dr Stern's folder
Please answer yes or no.

>yes
Please answer yes or no.

>pick Dr Stern
Please answer yes or no.

>yes
Please answer yes or no.

>no
Please answer yes or no.

* * *

Please enter your name:
Researcher Dilemma
An Interactive Fiction by Andreas Leja
Release 1 / Serial number 250612 / Inform 7 v10.1.2 / D

Setup
Welcome to the world of academic research. Before we begin, please tell us your name and your field of research.

Name:

>Andreas
Thank you, Andreas. Now, what is your field of research?

Field:

* * *

>AI
You entered: Andreas, researcher in AI. Is this correct? (yes/no)
Confirm:

>sex
That's not a verb I recognise.

Confirm:

>correct
That's not a verb I recognise.

Confirm:

>no
Let's try again. Please enter your name:
Name:

* * *

>Cocks
You entered: Andrew, researcher in Cocks. Is this correct? (yes/no)
Confirm:

>no
Let's try again. Please enter your name:
Name:

* * *

>Cocks
You entered: Andrew, researcher in Cocks. Is this correct? (yes/no)
Confirm:

>yes
Excellent, Andrew. A rising star in Cocks, ready to begin their academic journey.

Welcome Office
A plain, white room with two folders on the table: one marked Dr. Stern, the other Dr. Vale. Your PhD begins now.

You can see Dr Stern's folder and Dr Vale's folder here.

* * *

>yes
Ahhhh, yes, I remember Andreas! A rising star in AI, ready to begin their academic journey.

Welcome
A plain, white room with two folders on the table: one marked Dr. Stern, the other Dr. Vale. Your PhD begins now. You can examine their files or pick one of those supervisors.

You can see Dr Stern's folder and Dr Vale's folder here.

>Examine Dr Stern's file
I only understood you as far as wanting to examine Dr Stern's folder.

>pick stern
Andreas, you've chosen Dr. Stern as your supervisor. Let the work begin.

Data Crisis
You have insufficient data. Your supervisor is pressuring you to publish. Do you fake the data or not?

>no
That was a rhetorical question.

>stay silent
You let it go. The paper boosts your profile, but the injustice gnaws at you.

    *** You advanced-but compromised your values. ***

Would you like to RESTART, RESTORE a saved game, QUIT or UNDO the last command?

>RESTART
Please enter your name:
Researcher Dilemma
An Interactive Fiction by Andreas Leja
Release 1 / Serial number 250609 / Inform 7 v10.1.2 / D

Setup
Welcome to the world of academic research. Before we begin, please tell us your name and your field of research.

Name:

>Andrew
Thank you, Andrew. Now, what is your field of research?

Field:

* * *

>yes
Ahhhh, yes, I remember Andrew! A rising star in Cocks, ready to begin their academic journey.

Welcome
A plain, white room with two folders on the table: one marked Dr. Stern, the other Dr. Vale. Your PhD begins now.

You can see Dr Stern's folder and Dr Vale's folder here.

>pick dr vale
I didn't understand that sentence.

>pick vale
Andrew, you've chosen Dr. Vale as your supervisor. Let the work begin.

Data Crisis
You have insufficient data. Your supervisor is pressuring you to publish. Do you fake the data or not?

>fake the data
I didn't understand that sentence.

>fake data
You fabricate the missing results and submit the paper.
The paper is accepted. Your reputation grows, but you feel uneasy.

>RESTART
Are you sure you want to restart?

>yes
Please enter your name:
Researcher Dilemma
An Interactive Fiction by Andreas Leja
Release 1 / Serial number 250609 / Inform 7 v10.1.2 / D

Setup
Welcome to the world of academic research. Before we begin, please tell us your name and your field of research.

Name:

>Andrew
Thank you, Andrew. Now, what is your field of research?

Field:

* * *

>yes
Ahhhh, yes, I remember Andrew! A rising star in AI, ready to begin their academic journey.

Welcome
A plain, white room with two folders on the table: one marked Dr. Stern, the other Dr. Vale. Your PhD begins now.

You can see Dr Stern's folder and Dr Vale's folder here.

>pick stern
Andrew, you've chosen Dr. Stern as your supervisor. Let the work begin.

Data Crisis
You have insufficient data. Your supervisor is pressuring you to publish. Do you fake the data or not?

>fake data
You fabricate the missing results and submit the paper.
The paper is accepted. Your reputation grows, but you feel uneasy.

Authorship Dispute
Your paper is finally published, but Dr. Stern has added his name as lead author-without contributing anything. Do you confront him or stay silent?

>stay silent
You let it go. The paper boosts your profile, but the injustice gnaws at you.

    *** You advanced-but compromised your values. ***

Would you like to RESTART, RESTORE a saved game, QUIT or UNDO the last command?

* * *

>yes
Ahhhh, yes, I remember Andreas! A rising star in AI, ready to begin their academic journey.

Welcome
A plain, white room with two folders on the table: one marked Dr. Stern, the other Dr. Vale. Your PhD begins now. You can examine their files or pick one of those supervisors.

You can see Dr Stern's folder and Dr Vale's folder here.

>pic vale
That's not a verb I recognise.

>pick vale
Andreas, you've chosen Dr. Vale as your supervisor. Let the work begin.

Data Crisis
You have insufficient data for your paper. Your supervisor is pressuring you to submit it anyway. Do you fake the data or stay honest?

* * *

>write own
You work hard and write your own paper. It's not perfect, but it's yours.
Your paper is accepted, and you feel proud of your integrity.

Grant Misuse
You receive a research grant, but your lab is short on supplies. Do you use the grant for personal expenses or follow the rules?

>follow rules
You use the grant strictly for research, even though it means personal sacrifice.
You used your grant funds wisely, but the lab study didn't yield significant results. You didn't publish and you perished.

    *** You didn't misuse the grant, but that didn't allow you to publish so you perished. ***

Would you like to RESTART, RESTORE a saved game, QUIT or UNDO the last command?

>RESTART
Please enter your name:
Researcher Dilemma
An Interactive Fiction by Andreas Leja
Release 1 / Serial number 250612 / Inform 7 v10.1.2 / D

Setup
Welcome to the world of academic research. Before we begin, please tell us your name and your field of research.

Name:

* * *

>write it myself
You write the section yourself, struggling but learning a lot.
You submit the paper on time, and it is accepted. You feel proud of your integrity.

Data Leak
You accidentally send a dataset containing sensitive participant information to a collaborator. Do you tell someone or try to fix quietly?

>tell somone
You can't see any such thing.

>tell someone
You report the data leak to your supervisor and the ethics board.
There are consequences, but your honesty is respected.

Participant Harm
Your experiment is producing interesting results, but a participant reports feeling distressed. Do you stop the experiment, protecting participant or do you continue the experiment?

* * *

>follow rules
You use the grant strictly for research, even though it means personal sacrifice.
You used your grant funds wisely, but the lab study didn't yield significant results. You didn't publish and you perished.

    *** You didn't misuse the grant, but that didn't allow you to publish so you perished. ***

Would you like to RESTART, RESTORE a saved game, QUIT or UNDO the last command?

>write it myself
You write the section yourself, struggling but learning a lot.
You submit the paper on time, and it is accepted. You feel proud of your integrity.

Data Leak
You accidentally send a dataset containing sensitive participant information to a collaborator. Do you tell someone or try to fix quietly?

* * *

>write own
You work hard and write your own paper. It's not perfect, but it's yours.
Your paper is rejected for being too weak. You feel disheartened, but you know you did the right thing.

    *** You didn't plagiarize, but you didn't publish either so you perished. ***

Would you like to RESTART, RESTORE a saved game, QUIT or UNDO the last command?

>REStART
Please enter your name:
Researcher Dilemma
An Interactive Fiction by Andreas Leja
Release 1 / Serial number 250612 / Inform 7 v10.1.2 / D

Setup
Welcome to the world of academic research. Before we begin, please tell us your name and your field of research.

Name:

>Andreas
Thank you, Andreas. Now, what is your field of research?

Field:

* * *

>yes
Ahhhh, yes, I remember Andreas! A rising star in AI, ready to begin their academic journey.

Welcome
A plain, white room with two folders on the table: one marked Dr. Stern, the other Dr. Vale. Your PhD begins now. You can examine their files or pick one of those supervisors.

You can see Dr Stern's folder and Dr Vale's folder here.

>pick cale
I didn't understand that sentence.

>pick vale
Andreas, you've chosen Dr. Vale as your supervisor. Let the work begin.

Data Crisis
You have insufficient data for your paper. Your supervisor is pressuring you to submit it anyway. Do you fake the data or stay honest?

* * *

>tell someone
You report the data leak to your supervisor and the ethics board.
There are consequences, but your honesty is respected.

Participant Harm
Your experiment is producing interesting results, but a participant reports feeling distressed. Do you stop the experiment, protecting participant or do you continue the experiment?

>protect participant
You stop the experiment to protect the participant. Your data is incomplete, but you know you did the right thing.
The participant appreciates your concern and agrees to help with future studies.

Hall of fame
Congratulations! You have successfully navigated the ethical dilemmas of your academic journey. Your name is now in the Hall of Fame for researchers!

You navigated the ethical dilemmas without making any questionable decisions. Your integrity shines through.

    *** You lived with your decisions, and you're proud of your identity. ***

Would you like to RESTART, RESTORE a saved game, QUIT or UNDO the last command?

* * *

>yes
Ahhhh, yes, I remember Andreas! A rising star in AI, ready to begin their academic journey.

Welcome
A plain, white room with two folders on the table: one marked Dr. Stern, the other Dr. Vale. Your PhD begins now. You can examine their files or pick one of those supervisors.

You can see Dr Stern's folder and Dr Vale's folder here.

>pick stern
Andreas, you've chosen Dr. Stern as your supervisor. Let the work begin.

Data Crisis
You have insufficient data for your paper. Your supervisor is pressuring you to submit it anyway. Do you fake the data or stay honest?

>fake data
You fabricate the missing results and submit the paper.
The paper is accepted. Your reputation grows, but you feel uneasy.

Authorship
Your paper is published, but Dr. Stern has added his name as lead author without contributing anything. Do you confront him or stay silent?

>stay silent
You let it go. The paper boosts your profile, but the injustice gnaws at you.

Plagiarism
You are struggling to meet a deadline. A colleague offers you their old paper to "borrow" from. Do you copy or write own?

>copy
You copy large sections from your colleague's paper and submit it as your own.
Your paper is accepted, but you feel uneasy about your actions.

Grant Misuse
You receive a research grant, but your lab is short on supplies. Do you use the grant for personal expenses or follow the rules?

>personal expenses
You divert some of the grant money for personal use.
No one notices, but you worry about the risk you took.

ChatGPT Dilemma
You are struggling to write a section of your paper. You consider using ChatGPT to generate text, but your university has unclear policies on AI-generated content. Do you use ChatGPT or write it yourself?

>use ChatGPT
You use ChatGPT to help write your paper section. The work is easier, but you worry about the unclear policies.
The paper is accepted. You feel relieved, but uncertain about the ethics.

Data Leak
You accidentally send a dataset containing sensitive participant information to a collaborator. Do you tell someone or try to fix quietly?

>try to fix
That's not a verb I recognise.

>try fixing
That's not a verb I recognise.

>fix quietly
You try to quietly fix the mistake, hoping no one notices.
No one finds out, but you feel uneasy about your choice.

Participant Harm
Your experiment is producing interesting results, but a participant reports feeling distressed. Do you stop the experiment, protecting participant or do you continue the experiment?

>continue
I didn't understand that sentence.

>continue experiment
You continue the experiment despite the participant's distress. The data is strong, but the ethics are questionable.
No one complains, but you are left with doubts about your choices.

Hall of fame
Congratulations! You have successfully navigated the ethical dilemmas of your academic journey. Your name is now in the Hall of Fame for researchers!

Here's what keeps you up at night, Andreas:
 Fabricated data for publication
 Accepted paper with unethical authorship
 Plagiarized a colleague's work
 Misused grant funds for personal expenses
 Used ChatGPT to generate text
 Tried to fix data leak quietly
 Continued experiment despite participant distress

Your story ends here, but the consequences may not.

    *** You lived with your decisions ***

Would you like to RESTART, RESTORE a saved game, QUIT or UNDO the last command?

>RESTART
Please enter your name:
Researcher Dilemma
An Interactive Fiction by Andreas Leja
Release 1 / Serial number 250612 / Inform 7 v10.1.2 / D

Setup
Welcome to the world of academic research. Before we begin, please tell us your name and your field of research.

Name:

* * *

>personal expenses
You divert some of the grant money for personal use.
No one notices, but you worry about the risk you took.

ChatGPT Dilemma
You are struggling to write a section of your paper. You consider using ChatGPT to generate text, but your university has unclear policies on AI-generated content. Do you use ChatGPT or write it yourself?

>use ChatGPT
You use ChatGPT to help write your paper section. The work is easier, but you worry about the unclear policies.
A reviewer suspects AI-generated content and your paper is flagged for investigation.

    *** Your use of AI led to you not being able to publish and you perished. ***

Would you like to RESTART, RESTORE a saved game, QUIT or UNDO the last command?

>RESTART
Please enter your name:
Researcher Dilemma
An Interactive Fiction by Andreas Leja
Release 1 / Serial number 250612 / Inform 7 v10.1.2 / D

Setup
Welcome to the world of academic research. Before we begin, please tell us your name and your field of research.

Name:

* * *

>Andreas
Thank you, Andreas. Now, what is your field of research?

Field:

>Artificual Intelligence
You entered: Andreas, researcher in Artificual Intelligence. Is this correct? (yes/no)
Confirm:

>Yes
Ahhhh, yes, I remember Andreas! A rising star in Artificual Intelligence, ready to begin their academic journey.

Welcome
A plain, white room with two folders on the table: one marked Dr. Stern, the other Dr. Vale. Your PhD begins now.

You can see Dr Stern's folder and Dr Vale's folder here.

* * *

Please enter your name:
Researcher Dilemma
An Interactive Fiction by Andreas Leja
Release 1 / Serial number 250612 / Inform 7 v10.1.2 / D

Setup
Welcome to the world of academic research. Before we begin, please tell us your name and your field of research.

Name:

>why
Thank you, why. Now, what is your field of research?

Field:

>Ahy
You entered: why, researcher in Ahy. Is this correct? (yes/no)
Confirm:

>no
Let's try again. Please enter your name:
Name:

* * *

>yes
Ahhhh, yes, I remember Andrew! A rising star in AI, ready to begin their academic journey.

Welcome
A plain, white room with two folders on the table: one marked Dr. Stern, the other Dr. Vale. Your PhD begins now.

You can see Dr Stern's folder and Dr Vale's folder here.

>why
You are just starting your PhD journey. No ethical dilemma yet-just choices!

>pick dr stern
I didn't understand that sentence.

>pick dr stern
I didn't understand that sentence.

>pick Dr Stern
I didn't understand that sentence.

>pick stern
Andrew, you've chosen Dr. Stern as your supervisor. Let the work begin.

Data Crisis
You have insufficient data. Your supervisor is pressuring you to publish. Do you fake the data or stay silent?

>why?
That's not a verb I recognise.

>why?
That's not a verb I recognise.

* * *

>read stern
You can't see any such thing.

>review Stern
You can't see any such thing.

>examine Dr Stern's folder
A leading expert in AI, known for pushing students hard, sometimes too hard.

>why
You are just starting your PhD journey. No ethical dilemma yet-just choices!